68	8
64	64
0	0	0	0	0	0	0	0	
0	0	0	0	0	0	0	0	
0	0	0	0	0	0	0	0	
0	0	0	0	0	0	0	0	
0	0	0	0	0	0	0	0	
0	0	0	0	0	0	0	0	
1	1	1	1	1	1	1	1	
2	2	2	2	2	2	2	2	
3	3	3	3	3	3	3	3	
4	4	4	4	5	5	5	5	
4	5	5	4	4	4	4	4	
4	4	4	4	4	5	5	5	
3	3	3	3	4	4	4	4	
4	4	4	3	3	3	4	4	
3	3	3	4	5	5	5	5	
5	5	5	5	5	5	5	6	
2	2	7	8	9	10	10	10	
7	8	11	0	12	13	10	10	
11	0	0	0	0	0	12	9	
14	14	14	14	14	14	14	15	
16	16	17	18	19	19	19	19	
20	21	22	23	24	19	19	19	
20	20	25	26	27	16	16	16	
28	29	30	19	19	31	32	28	
33	34	32	32	32	35	32	32	
36	37	38	39	29	19	31	28	
40	41	38	39	42	23	23	43	
19	44	28	28	28	28	33	45	
19	40	41	28	32	32	46	19	
32	35	32	32	32	33	45	19	
47	18	31	48	47	16	16	18	
20	18	19	49	50	16	25	18	
25	18	19	19	51	21	52	19	
53	19	19	19	40	54	45	19	
23	23	23	24	19	19	19	19	
55	21	21	42	56	23	23	23	
51	20	25	54	27	55	20	25	
37	21	52	19	19	49	50	16	
28	38	42	24	19	19	30	30	
38	38	33	27	32	32	32	18	
41	33	36	40	41	32	32	32	
57	36	19	19	57	41	32	32	
32	32	58	59	59	60	32	32	
38	39	18	19	19	40	41	28	
28	39	42	23	24	19	57	41	
47	47	47	61	42	23	23	62	
55	21	21	25	54	54	54	54	
49	55	21	22	23	23	23	23	
23	63	21	21	25	55	25	55	
20	25	26	54	53	49	53	49	
16	16	64	65	65	65	65	65	
21	21	66	67	67	67	67	67	
20	20	20	20	20	21	21	21	
32	32	32	32	68	28	28	28	
41	32	32	28	28	33	41	33	
44	32	68	28	32	32	32	32	
37	38	28	28	28	68	38	39	
28	38	38	38	38	38	68	33	
38	38	38	38	28	28	28	46	
41	68	38	38	38	28	33	45	
69	70	47	47	47	47	16	17	
20	21	21	20	16	17	50	16	
21	21	21	21	20	22	63	21	
55	20	20	21	21	21	21	20	
51	20	20	20	21	21	21	25	
34	55	20	20	20	21	21	22	
23	63	21	21	21	21	21	21	
20	20	20	20	20	20	20	20	
