5851	0	4080	272	272	0	1	2	3	4	8	9	10	11	12	16	17	18	19	20	24	25	26	27	28	32	33	34	35	36
5852	272	4080	272	272	4	5	6	7	12	13	14	15	20	21	22	23	28	29	30	31	36	37	38	39
5849	0	3808	272	272	32	33	34	35	36	40	41	42	43	44	48	49	50	51	52	56	57	58	59	60	64	65	66	67	68
5850	272	3808	272	272	36	37	38	39	44	45	46	47	52	53	54	55	60	61	62	63	68	69	70	71
731	0	3808	544	544
732	544	3808	544	544
5835	0	3536	272	272	64	65	66	67	68	72	73	74	75	76	80	81	82	83	84	88	89	90	91	92	96	97	98	99	100
5836	272	3536	272	272	68	69	70	71	76	77	78	79	84	85	86	87	92	93	94	95	100	101	102	103
5833	0	3264	272	272	96	97	98	99	100	104	105	106	107	108	112	113	114	115	116	120	121	122	123	124	128	129	130	131	132
5834	272	3264	272	272	100	101	102	103	108	109	110	111	116	117	118	119	124	125	126	127	132	133	134	135
729	0	3264	544	544
730	544	3264	544	544
91	0	3264	1088	1088
92	1088	3264	1088	1088
5723	0	2992	272	272	136	137	138	139	140	144	145	146	147	148	152	153	154	155	156	160	161	162	163	164	168	169	170	171	172
5724	272	2992	272	272	140	141	142	143	148	149	150	151	156	157	158	159	164	165	166	167	172	173	174	175
5721	0	2720	272	272	168	169	170	171	172	176	177	178	179	180	184	185	186	187	188	192	193	194	195	196	200	201	202	203	204
5722	272	2720	272	272	172	173	174	175	180	181	182	183	188	189	190	191	196	197	198	199	204	205	206	207
715	0	2720	544	544
716	544	2720	544	544
5707	0	2448	272	272	200	201	202	203	204	208	209	210	211	212	216	217	218	219	220	224	225	226	227	228	232	233	234	235	236
5708	272	2448	272	272	204	205	206	207	212	213	214	215	220	221	222	223	228	229	230	231	236	237	238	239
5705	0	2176	272	272	232	233	234	235	236	240	241	242	243	244	248	249	250	251	252	256	257	258	259	260	264	265	266	267	268
5706	272	2176	272	272	236	237	238	239	244	245	246	247	252	253	254	255	260	261	262	263	268	269	270	271
713	0	2176	544	544
714	544	2176	544	544
89	0	2176	1088	1088
90	1088	2176	1088	1088
11	0	2176	2176	2176
12	2176	2176	2176	2176
4827	0	1904	272	272	272	273	274	275	276	280	281	282	283	284	288	289	290	291	292	296	297	298	299	300	304	305	306	307	308
4828	272	1904	272	272	276	277	278	279	284	285	286	287	292	293	294	295	300	301	302	303	308	309	310	311
4825	0	1632	272	272	304	305	306	307	308	312	313	314	315	316	320	321	322	323	324	328	329	330	331	332	336	337	338	339	340
4826	272	1632	272	272	308	309	310	311	316	317	318	319	324	325	326	327	332	333	334	335	340	341	342	343
603	0	1632	544	544
604	544	1632	544	544
4811	0	1360	272	272	336	337	338	339	340	344	345	346	347	348	352	353	354	355	356	360	361	362	363	364	368	369	370	371	372
4812	272	1360	272	272	340	341	342	343	348	349	350	351	356	357	358	359	364	365	366	367	372	373	374	375
4809	0	1088	272	272	368	369	370	371	372	376	377	378	379	380	384	385	386	387	388	392	393	394	395	396	400	401	402	403	404
4810	272	1088	272	272	372	373	374	375	380	381	382	383	388	389	390	391	396	397	398	399	404	405	406	407
601	0	1088	544	544
602	544	1088	544	544
75	0	1088	1088	1088
76	1088	1088	1088	1088
4699	0	816	272	272	408	409	410	411	412	416	417	418	419	420	424	425	426	427	428	432	433	434	435	436	440	441	442	443	444
4700	272	816	272	272	412	413	414	415	420	421	422	423	428	429	430	431	436	437	438	439	444	445	446	447
4697	0	544	272	272	440	441	442	443	444	448	449	450	451	452	456	457	458	459	460	464	465	466	467	468	472	473	474	475	476
4698	272	544	272	272	444	445	446	447	452	453	454	455	460	461	462	463	468	469	470	471	476	477	478	479
587	0	544	544	544
588	544	544	544	544
4683	0	272	272	272	472	473	474	475	476	480	481	482	483	484	488	489	490	491	492	496	497	498	499	500	504	505	506	507	508
4684	272	272	272	272	476	477	478	479	484	485	486	487	492	493	494	495	500	501	502	503	508	509	510	511
4681	0	0	272	272	504	505	506	507	508	512	513	514	515	516	520	521	522	523	524	528	529	530	531	532	536	537	538	539	540
4682	272	0	272	272	508	509	510	511	516	517	518	519	524	525	526	527	532	533	534	535	540	541	542	543
585	0	0	544	544
586	544	0	544	544
73	0	0	1088	1088
74	1088	0	1088	1088
9	0	0	2176	2176
10	2176	0	2176	2176
1	0	0	4352	4352
