7	159
64	64
0	0	1	0	2	1	0	0	0	1	2	1	0	2	0	0	0	0	2	0	0	1	2	0	0	2	1	1	0	2	1	0	0	2	1	2	1	0	3	4	1	0	2	3	5	4	0	0	0	2	1	0	0	1	2	0	0	0	2	1	0	2	0	1	0	0	0	0	0	1	0	0	0	0	0	0	0	0	0	0	0	0	0	0	0	0	0	0	0	0	0	0	0	0	0	1	0	2	0	0	0	0	0	0	0	0	0	0	0	0	0	0	0	0	0	0	0	0	0	6	7	6	8	9	10	11	7	0	0	0	10	11	7	6	7	0	10	11	7	0	0	0	6	7	0	0	0	0	0	0	0	0	0	0	0	0	0	0	0	
0	1	0	1	1	1	2	0	3	5	5	5	5	5	5	4	0	0	0	1	2	2	1	0	0	0	1	1	1	0	0	0	0	1	0	2	0	0	12	13	2	1	0	12	14	13	0	0	0	1	0	0	2	2	1	0	0	2	1	1	0	1	2	1	0	1	0	0	1	0	0	0	0	0	0	0	0	0	0	0	0	0	0	0	0	0	0	0	0	0	0	0	0	2	0	1	0	1	0	0	0	0	0	0	0	0	0	0	0	0	0	0	0	0	0	0	0	0	0	0	10	15	16	16	16	16	17	8	9	10	11	7	0	0	0	0	0	0	10	9	10	9	0	0	0	0	0	0	0	0	0	0	0	0	0	0	0	0	0	
0	1	2	2	2	1	0	0	12	14	14	14	14	14	14	13	0	1	2	0	0	0	1	0	0	2	0	2	0	0	18	19	19	20	0	0	21	19	22	23	20	0	18	22	22	23	20	0	0	18	19	19	20	0	0	0	0	1	0	0	0	0	0	0	0	0	0	0	1	0	0	0	0	0	0	0	0	0	0	0	0	0	0	0	0	0	0	0	0	0	0	0	2	1	0	2	0	0	0	0	0	0	0	0	0	0	0	0	0	0	0	0	0	0	0	0	0	0	0	0	6	24	25	25	25	25	26	0	0	0	0	0	10	9	0	0	0	10	9	6	27	7	0	0	0	0	0	0	0	0	0	0	0	0	0	0	28	29	30	
0	0	0	1	0	0	1	0	31	31	31	31	31	31	31	32	0	0	33	34	34	35	0	0	0	0	0	0	0	0	36	37	37	38	0	0	39	37	40	40	38	0	36	37	37	37	38	0	0	41	42	40	43	18	20	44	45	0	0	0	0	0	0	44	45	0	0	0	0	0	0	0	0	0	0	0	0	0	0	0	0	0	0	0	0	0	0	0	0	0	0	0	0	18	19	20	0	0	0	0	0	0	0	0	0	0	0	0	0	0	0	0	0	0	0	0	0	0	0	10	9	46	47	47	47	47	48	49	50	51	50	51	50	52	35	0	0	0	0	0	0	0	0	0	0	0	0	0	0	0	0	0	0	0	0	0	53	54	55	
34	56	34	56	34	56	34	56	34	56	34	56	34	56	34	56	34	45	41	42	42	57	0	44	34	34	58	0	0	33	34	34	56	34	56	34	56	45	59	60	44	56	34	56	34	56	45	0	0	59	61	61	38	36	62	41	63	0	44	45	0	64	0	41	63	0	44	56	34	56	45	0	0	0	0	0	0	0	0	0	0	0	0	0	0	0	0	0	0	0	0	0	0	36	37	62	0	44	45	0	0	0	0	0	0	0	0	0	0	0	0	0	0	0	0	0	0	0	0	0	49	65	50	51	50	52	35	66	67	67	67	67	67	67	68	69	50	51	50	51	50	70	71	0	0	0	0	0	0	0	0	0	0	0	0	0	72	73	74	
61	61	61	61	61	61	61	61	61	61	61	61	61	61	61	61	61	75	76	77	77	78	20	41	61	60	79	19	19	76	59	61	61	61	61	61	61	60	0	0	59	61	61	61	75	41	63	0	0	44	56	34	56	34	45	41	63	80	41	63	80	41	80	41	63	80	41	42	42	42	63	81	82	81	82	81	82	81	82	81	82	81	82	81	82	81	83	82	83	82	82	44	56	34	56	34	45	41	63	82	81	82	81	82	81	82	81	82	81	82	81	82	81	82	84	82	84	82	82	82	85	86	87	88	89	89	90	91	92	93	93	93	93	94	95	96	89	89	89	89	89	89	97	82	84	82	84	82	84	82	82	82	82	82	82	82	98	99	100	
101	101	101	101	101	101	101	101	101	101	101	101	101	101	101	101	101	102	36	37	37	37	62	103	101	104	36	37	37	62	105	101	101	101	101	101	101	101	101	101	101	101	101	101	102	59	75	44	45	41	42	42	42	42	63	41	63	106	107	107	108	107	106	107	107	108	41	109	109	109	63	82	82	82	82	82	82	82	82	82	82	82	82	82	82	82	82	82	82	82	82	59	61	61	61	61	60	41	63	82	82	82	82	82	82	82	82	82	82	82	82	82	82	82	82	82	82	82	82	82	110	111	112	113	114	115	116	117	118	118	118	118	118	118	119	120	114	114	114	114	114	115	121	82	82	82	82	82	82	82	82	82	82	82	82	82	82	82	82	
