11	0	1664	1664	1664
12	1664	1664	1664	1664
75	0	832	832	832
76	832	832	832	832
587	0	416	416	416
588	416	416	416	416
4683	0	208	208	208	520	521	522	523	524	525	526	624	625	626	627	628	629	630
4684	208	208	208	208	525	526	527	528	529	530	531	532	533	629	630	631	632	633	634	635	636	637
4681	0	0	208	208	0	1	2	3	4	5	6	104	105	106	107	108	109	110	208	209	210	211	212	213	214	312	313	314	315	316	317	318	416	417	418	419	420	421	422	520	521	522	523	524	525	526	624	625	626	627	628	629	630
4682	208	0	208	208	5	6	7	8	9	10	11	12	13	109	110	111	112	113	114	115	116	117	213	214	215	216	217	218	219	220	221	317	318	319	320	321	322	323	324	325	421	422	423	424	425	426	427	428	429	525	526	527	528	529	530	531	532	533	629	630	631	632	633	634	635	636	637
585	0	0	416	416
4691	416	208	208	208	531	532	533	534	535	536	537	538	539	635	636	637	638	639	640	641	642	643
4692	624	208	208	208	538	539	540	541	542	543	544	545	546	642	643	644	645	646	647	648	649	650
4689	416	0	208	208	11	12	13	14	15	16	17	18	19	115	116	117	118	119	120	121	122	123	219	220	221	222	223	224	225	226	227	323	324	325	326	327	328	329	330	331	427	428	429	430	431	432	433	434	435	531	532	533	534	535	536	537	538	539	635	636	637	638	639	640	641	642	643
4690	624	0	208	208	18	19	20	21	22	23	24	25	26	122	123	124	125	126	127	128	129	130	226	227	228	229	230	231	232	233	234	330	331	332	333	334	335	336	337	338	434	435	436	437	438	439	440	441	442	538	539	540	541	542	543	544	545	546	642	643	644	645	646	647	648	649	650
586	416	0	416	416
73	0	0	832	832
595	832	416	416	416
596	1248	416	416	416
4747	832	208	208	208	544	545	546	547	548	549	550	551	552	648	649	650	651	652	653	654	655	656
4748	1040	208	208	208	551	552	553	554	555	556	557	558	559	655	656	657	658	659	660	661	662	663
4745	832	0	208	208	24	25	26	27	28	29	30	31	32	128	129	130	131	132	133	134	135	136	232	233	234	235	236	237	238	239	240	336	337	338	339	340	341	342	343	344	440	441	442	443	444	445	446	447	448	544	545	546	547	548	549	550	551	552	648	649	650	651	652	653	654	655	656
4746	1040	0	208	208	31	32	33	34	35	36	37	38	39	135	136	137	138	139	140	141	142	143	239	240	241	242	243	244	245	246	247	343	344	345	346	347	348	349	350	351	447	448	449	450	451	452	453	454	455	551	552	553	554	555	556	557	558	559	655	656	657	658	659	660	661	662	663
593	832	0	416	416
4755	1248	208	208	208	557	558	559	560	561	562	563	564	565	661	662	663	664	665	666	667	668	669
4756	1456	208	208	208	564	565	566	567	568	569	570	571	572	668	669	670	671	672	673	674	675	676
4753	1248	0	208	208	37	38	39	40	41	42	43	44	45	141	142	143	144	145	146	147	148	149	245	246	247	248	249	250	251	252	253	349	350	351	352	353	354	355	356	357	453	454	455	456	457	458	459	460	461	557	558	559	560	561	562	563	564	565	661	662	663	664	665	666	667	668	669
4754	1456	0	208	208	44	45	46	47	48	49	50	51	52	148	149	150	151	152	153	154	155	156	252	253	254	255	256	257	258	259	260	356	357	358	359	360	361	362	363	364	460	461	462	463	464	465	466	467	468	564	565	566	567	568	569	570	571	572	668	669	670	671	672	673	674	675	676
594	1248	0	416	416
74	832	0	832	832
9	0	0	1664	1664
83	1664	832	832	832
84	2496	832	832	832
651	1664	416	416	416
652	2080	416	416	416
5195	1664	208	208	208	570	571	572	573	574	575	576	577	578	674	675	676	677	678	679	680	681	682
5196	1872	208	208	208	577	578	579	580	581	582	583	584	585	681	682	683	684	685	686	687	688	689
5193	1664	0	208	208	50	51	52	53	54	55	56	57	58	154	155	156	157	158	159	160	161	162	258	259	260	261	262	263	264	265	266	362	363	364	365	366	367	368	369	370	466	467	468	469	470	471	472	473	474	570	571	572	573	574	575	576	577	578	674	675	676	677	678	679	680	681	682
5194	1872	0	208	208	57	58	59	60	61	62	63	64	65	161	162	163	164	165	166	167	168	169	265	266	267	268	269	270	271	272	273	369	370	371	372	373	374	375	376	377	473	474	475	476	477	478	479	480	481	577	578	579	580	581	582	583	584	585	681	682	683	684	685	686	687	688	689
649	1664	0	416	416
5203	2080	208	208	208	583	584	585	586	587	588	589	590	591	687	688	689	690	691	692	693	694	695
5204	2288	208	208	208	590	591	592	593	594	595	596	597	598	694	695	696	697	698	699	700	701	702
5201	2080	0	208	208	63	64	65	66	67	68	69	70	71	167	168	169	170	171	172	173	174	175	271	272	273	274	275	276	277	278	279	375	376	377	378	379	380	381	382	383	479	480	481	482	483	484	485	486	487	583	584	585	586	587	588	589	590	591	687	688	689	690	691	692	693	694	695
5202	2288	0	208	208	70	71	72	73	74	75	76	77	78	174	175	176	177	178	179	180	181	182	278	279	280	281	282	283	284	285	286	382	383	384	385	386	387	388	389	390	486	487	488	489	490	491	492	493	494	590	591	592	593	594	595	596	597	598	694	695	696	697	698	699	700	701	702
650	2080	0	416	416
81	1664	0	832	832
659	2496	416	416	416
660	2912	416	416	416
5259	2496	208	208	208	596	597	598	599	600	601	602	603	604	700	701	702	703	704	705	706	707	708
5260	2704	208	208	208	603	604	605	606	607	608	609	610	611	707	708	709	710	711	712	713	714	715
5257	2496	0	208	208	76	77	78	79	80	81	82	83	84	180	181	182	183	184	185	186	187	188	284	285	286	287	288	289	290	291	292	388	389	390	391	392	393	394	395	396	492	493	494	495	496	497	498	499	500	596	597	598	599	600	601	602	603	604	700	701	702	703	704	705	706	707	708
5258	2704	0	208	208	83	84	85	86	87	88	89	90	91	187	188	189	190	191	192	193	194	195	291	292	293	294	295	296	297	298	299	395	396	397	398	399	400	401	402	403	499	500	501	502	503	504	505	506	507	603	604	605	606	607	608	609	610	611	707	708	709	710	711	712	713	714	715
657	2496	0	416	416
5267	2912	208	208	208	609	610	611	612	613	614	615	616	617	713	714	715	716	717	718	719	720	721
5268	3120	208	208	208	616	617	618	619	620	621	622	623	720	721	722	723	724	725	726	727
5265	2912	0	208	208	89	90	91	92	93	94	95	96	97	193	194	195	196	197	198	199	200	201	297	298	299	300	301	302	303	304	305	401	402	403	404	405	406	407	408	409	505	506	507	508	509	510	511	512	513	609	610	611	612	613	614	615	616	617	713	714	715	716	717	718	719	720	721
5266	3120	0	208	208	96	97	98	99	100	101	102	103	200	201	202	203	204	205	206	207	304	305	306	307	308	309	310	311	408	409	410	411	412	413	414	415	512	513	514	515	516	517	518	519	616	617	618	619	620	621	622	623	720	721	722	723	724	725	726	727
658	2912	0	416	416
82	2496	0	832	832
10	1664	0	1664	1664
1	0	0	3328	3328
