5851	0	4080	272	272	113
5852	272	4080	272	272	113
5849	0	3808	272	272	0	1	71	72
5850	272	3808	272	272	0	1	70	72
731	0	3808	544	544
732	544	3808	544	544
5835	0	3536	272	272	2	3	5	6	66	67	72
5836	272	3536	272	272	2	4	6	70	72
5833	0	3264	272	272	6	7	8	9	67	69
5834	272	3264	272	272	6	8	9	10	68	69
729	0	3264	544	544
730	544	3264	544	544
91	0	3264	1088	1088
92	1088	3264	1088	1088
5723	0	2992	272	272	12	13	75	103
5724	272	2992	272	272	11	73	74
5721	0	2720	272	272	13	17	18	75	77	80	102
5722	272	2720	272	272	14	15	16	17	77	79	104
715	0	2720	544	544
716	544	2720	544	544
5707	0	2448	272	272	18	19	20	21	22	77	78	82
5708	272	2448	272	272	19	20	22	23	76	77	79	81
5705	0	2176	272	272	24	82	84	101
5706	272	2176	272	272	23	24	25	84
713	0	2176	544	544
714	544	2176	544	544
89	0	2176	1088	1088
90	1088	2176	1088	1088
11	0	2176	2176	2176
12	2176	2176	2176	2176
4827	0	1904	272	272	26	27	30	31	83	100
4828	272	1904	272	272	28	29	83
4825	0	1632	272	272	31	32	33	36	105
4826	272	1632	272	272	32	34	35	36	99	105
603	0	1632	544	544
604	544	1632	544	544
4811	0	1360	272	272	37	38	39	40	85	106
4812	272	1360	272	272	39	86	99	107
4809	0	1088	272	272	41	42	43	95	96	97
4810	272	1088	272	272	41	87	88	95	96	97
601	0	1088	544	544
602	544	1088	544	544
75	0	1088	1088	1088
76	1088	1088	1088	1088
4699	0	816	272	272	44	45	47	48	49	89	95	96	97	98	108	109
4700	272	816	272	272	44	46	49	89	95	96	97	98	108
4697	0	544	272	272	50	52	53	54	90	91	92	93	97	98	112
4698	272	544	272	272	51	52	54	90	91	94	97	98	110	111
587	0	544	544	544
588	544	544	544	544
4683	0	272	272	272	54	56	57	58	60	61	65	92
4684	272	272	272	272	54	55	58	59	61	65
4681	0	0	272	272	62	64	65
4682	272	0	272	272	62	63	64	65
585	0	0	544	544
586	544	0	544	544
73	0	0	1088	1088
74	1088	0	1088	1088
9	0	0	2176	2176
10	2176	0	2176	2176
1	0	0	4352	4352
